[console_scripts]
scappendlinetofile = ScriptCollection.Executables:AppendLineToFile
scbuildcodeunit = ScriptCollection.Executables:BuildCodeUnit
scbuildcodeunits = ScriptCollection.Executables:BuildCodeUnits
scbuildcodeunitsc = ScriptCollection.Executables:BuildCodeUnitsC
sccalculatebitcoinblockhash = ScriptCollection.Executables:CalculateBitcoinBlockHash
scchangefileextension = ScriptCollection.Executables:ChangeFileExtensions
scchangehashofprogram = ScriptCollection.Executables:ChangeHashOfProgram
sccreatechangelogentry = ScriptCollection.Executables:CreateChangelogEntry
sccreateemptyfilewithspecificsize = ScriptCollection.Executables:CreateEmptyFileWithSpecificSize
sccreatefile = ScriptCollection.Executables:CreateFile
sccreatefolder = ScriptCollection.Executables:CreateFolder
sccreatehashofallfiles = ScriptCollection.Executables:CreateHashOfAllFiles
sccreateisofilewithobfuscatedfiles = ScriptCollection.Executables:CreateISOFileWithObfuscatedFiles
sccreatesimplemergewithoutrelease = ScriptCollection.Executables:CreateSimpleMergeWithoutRelease
scextractpdfpages = ScriptCollection.Executables:ExtractPDFPages
scfilecontainscontent = ScriptCollection.Executables:FileContainsContent
scfileexists = ScriptCollection.Executables:FileExists
scfilenameobfuscator = ScriptCollection.Executables:FilenameObfuscator
scfolderexists = ScriptCollection.Executables:FolderExists
scgeneratearc42referencetemplate = ScriptCollection.Executables:GenerateARC42ReferenceTemplate
scgeneratecertificate = ScriptCollection.Executables:GenerateCertificate
scgeneratecertificateauthority = ScriptCollection.Executables:GenerateCertificateAuthority
scgeneratecertificatesignrequest = ScriptCollection.Executables:GenerateCertificateSignRequest
scgeneratesnkfiles = ScriptCollection.Executables:GenerateSnkFiles
scgeneratethumbnail = ScriptCollection.Executables:GenerateThumbnail
schealthcheck = ScriptCollection.Executables:Healthcheck
sckeyboarddiagnosis = ScriptCollection.Executables:KeyboardDiagnosis
scmergepdfs = ScriptCollection.Executables:MergePDFs
scobfuscatefilesfolder = ScriptCollection.Executables:ObfuscateFilesFolder
scorganizelinesinfile = ScriptCollection.Executables:OrganizeLinesInFile
scpdftoimage = ScriptCollection.Executables:PDFToImage
scprintfilecontent = ScriptCollection.Executables:PrintFileContent
scprintfilesize = ScriptCollection.Executables:PrintFileSize
scregexreplaceinfile = ScriptCollection.Executables:RegexReplaceInFile
scremoveFolder = ScriptCollection.Executables:RemoveFolder
scremovefile = ScriptCollection.Executables:RemoveFile
screname = ScriptCollection.Executables:Rename
screplacesubstringsinfilenames = ScriptCollection.Executables:ReplaceSubstringsInFilenames
scsearchinfiles = ScriptCollection.Executables:SearchInFiles
scsetcontentoffile = ScriptCollection.Executables:SetContentOfFile
scshow2faasqrcode = ScriptCollection.Executables:Show2FAAsQRCode
scshowmissingfiles = ScriptCollection.Executables:ShowMissingFiles
scsigncertificate = ScriptCollection.Executables:SignCertificate
scupdatenugetpackagesincsharpproject = ScriptCollection.Executables:UpdateNugetpackagesInCsharpProject
scuploadfile = ScriptCollection.Executables:UploadFile
